これ: this one
それ: that one
あれ: that one over there
どれ: which one
この: this
その: that
あの: that over there
どの: which
ここ: here
そこ: there
あそこ: over there
どこ: where
だれ: who
おいしい: delicious
さかな: fish
とんかつ: pork cutlet
にく: meat
メニュー: menu
やさい: vegatable
えんびつ: pencil
かさ: umbrella
かばん: bag
くつ:  shoes
さいふ: wallet
ジーンズ: jeans
じしょ: dictionary
じてんしゃ: bicycle
しんぶん: newspaper
Tシャツ: T-shirt
とけい: watch
ノート: notebook
ペン: pen
ぼうし: hat
ほん:  book
きっさてん: cafe
ぎんこう: bank
トイレ: toilet
としょかん: library
ゆうびんきゅく: post office
アメリカ: America
イギリス: Britain
かんこく: Korea
ちゅうこく: China
けいざい: economics
コンピューター: computer 
ビジネス: business
れきし: history 
おかあさん: mother
おとううさん: father
いくら: how much
えん: yen
たかい: expensive 
いらっしゃいませ: Welcome 
おねがいします: please
ください: please give me
じゃあ: then
どうぞ: here it is
どうも: thank you
